9,7,
13,13,13,13,13,13,13,13,13,
13,1,9,9,9,9,9,9,13,
13,9,4,4,4,4,4,9,13,
13,9,0,4,4,4,4,9,13,
13,9,4,4,4,4,4,9,13,
13,9,9,9,7,9,8,9,13,
13,13,13,13,13,13,13,13,13