5,8,
9,9,9,9,9,
9,4,0,4,9,
9,4,4,4,9,
9,4,4,4,9,
9,4,4,4,9,
9,4,4,4,9,
9,6,1,4,9,
9,9,9,9,9