9,7,
2,2,2,2,2,2,2,2,2,
2,1,9,9,9,9,9,9,2,
2,9,4,4,4,4,4,9,2,
2,0,4,4,4,4,4,9,2,
2,9,4,4,4,4,4,9,2,
2,9,9,9,7,9,9,9,2,
2,2,2,2,2,2,2,2,2