14,12,
9,9,9,9,9,9,9,9,9,9,9,9,9,9,
9,0,4,4,4,4,6,9,6,9,9,9,9,9,
9,4,4,4,4,4,7,9,9,9,9,9,9,9,
9,4,4,4,4,4,7,9,9,9,9,9,9,9,
9,4,4,4,4,4,9,9,9,9,9,9,9,9,
9,4,4,4,4,4,8,8,8,8,8,8,8,9,
9,4,4,4,4,4,4,4,4,4,4,4,4,9,
9,4,4,4,4,4,4,4,4,4,4,4,4,9,
9,4,4,4,4,4,4,4,4,4,4,4,4,9,
9,4,4,4,4,4,4,4,4,4,4,4,4,9,
9,3,4,4,4,4,4,4,4,4,4,4,1,9,
9,9,9,9,9,9,9,9,9,9,9,9,9,9