9,7,
2,2,2,2,2,2,2,2,2,
2,1,10,10,10,10,10,10,2,
2,10,10,10,10,10,10,10,2,
2,0,10,10,10,10,10,10,2,
2,10,10,10,10,10,10,10,2,
2,10,10,10,10,10,10,10,2,
2,2,2,2,2,2,2,2,2