9,7,
2,2,2,2,2,2,2,2,2,
2,1,4,4,4,4,4,11,2,
2,4,4,4,4,4,4,4,2,
2,0,4,4,4,4,4,4,2,
2,11,4,4,4,4,4,4,2,
2,4,4,4,4,4,4,11,2,
2,2,2,2,2,2,2,2,2