14,12,
9,9,9,9,9,9,9,9,9,9,9,9,9,9,
9,0,7,4,4,4,11,4,4,4,4,4,3,9,
9,4,7,4,4,4,8,4,4,4,4,4,4,9,
9,4,4,4,4,4,4,4,4,4,4,4,4,9,
9,4,4,4,4,4,4,4,4,4,4,4,4,9,
9,9,9,9,9,9,9,8,8,8,8,4,11,9,
9,9,9,9,9,9,9,4,4,4,4,4,4,9,
9,9,9,9,9,9,9,4,4,4,4,4,4,9,
9,9,9,9,9,9,9,4,4,1,4,4,4,9,
9,9,9,9,9,9,9,4,4,4,4,4,4,9,
9,9,9,9,9,9,9,3,4,4,4,4,11,9,
9,9,9,9,9,9,9,9,9,9,9,9,9,9